+-+-+-+-+
| |     |
+ + +-+ +
|     | |
+ +-+ + +
|   | | |
+-+-+-+ +