+ +-+-+-+
| |     |
+ + +-+ +
|     | |
+ +-+ + +
|   | | |
+-+-+-+-+