+-+-+-+-+-+-+-+-+-+-+
| |         | |      
+ + +-+ +-+-+ + +-+-+
|     |   |         |
+ +-+ + + +-+ +-+ +-+
|   | | |       |   |
+-+ +-+ + +-+ +-+-+ +
|       |       |   |
+-+-+-+-+-+-+-+-+-+-+