+-+-+-+-+-+-+-+-+-+-+
| |         | |      
+ + +-+ +-+-+ + +-+-+
|     |   |         |
+ +-+ + + +-+ +-+ +-+
|   | | |       |   |
+-+ +-+ + +-+ +-+-+-+
|       |       |   |
+-+-+-+-+-+-+-+-+-+-+