+ +-+-+-+-+-+-+-+-+-+-+-+
| |         | |         |
+ + +-+ +-+-+ + +-+-+ + +
|     |   |         | | |
+ +-+ + + +-+ +-+ +-+ + +
|   | | |       |   | | |
+-+ +-+ + +-+ +-+-+ + + +
|       |           |   |
+-+-+-+-+-+-+-+-+-+-+-+-+
